30 30
o o o o o o o o o o o o o o o o o o o o o o o o o o o o o o
o o o o o o o o o o o o o o o o o o o o o o o o o o o o o o
o o o o o o o o o o o o o o o o o o o o o o o o o o o o o o
o o o o o o o o t o o o o o o o o o o o o o o o o o o t o o
o o o o o o o t t t o o o o o o o o o o o o o o o o t t t o
o o o o o o o t t t o o o o o o o o o o o o o o o o t t t t
o o o o o o o t o t o o o o o o o o o o o o o o o o t t t o
o o o o o o o t t o o o o o o o o o o o t t t t o o o t o o
o o o o o o o o t t o o o o o o o o o o t o o t o o o o o o
o o o o o o o o t o o o o o o o o o o o t o t o o o o o o o
o o o o o o o o t o o o o o o o o o o o t t t o o o o o o o
o o o o o o o t t o o o o o o o o o o o o o o o o o o o o o
o o o o o o o t t o o o o o o o o o o o o o o o o o o o o o
o o o o o o t t o o o o o o o o o o o o o o o o o o o o o o
o o o o o t t t o o o o o o o o o o o o o o o o o o o o o o
o o o o t t t t o o o o o o o t o o o o o o o o o o o o o o
o o o o o t t o o o o o o o t t o o o o o o o o o o o o o o
o o o o o o t t o o o o o o o o o o o o o o o o o o o o o o
o o o o o o t t o o o o o o o o o o o o o o o t o o o o o o
o o o o o o o o o o o o o o o o o o o o o o o t t o o o o o
o o o o o o o o o o o o o o o o o o o o o o o t o o o o o o
o o o o o o o o o o o o o o o o o o o o o o t t o o o o o o
o o o o o o o o o o o o o o o o o o o o o o t o o o o o o o
o o o o o o o o o o o o o o t t o o o o o o o o o o o o o o
o o o o o o o o o o o o o o t t t o o o o o o o o o o o o o
o o o o o o o o o o o o o t t t t o o o o o o o o o o o o o
o o o o o o o o o o o o o o t o o o o o o o o o o o o o o o
o o o o o o o o o o o o o o o o o o o o o o o o o o o o o o
o o o o o o o o o o o o o o o o o o o o o o o o o o o o o o
o o o o o o o o o o o o o o o o o o o o o o o o o o o o o o
